8 8
2 1 1 1 1 1 1 2
1 2 1 1 1 1 2 1
1 1 1 1 1 1 1 1
1 1 1 2 2 1 1 1
1 1 1 2 2 1 1 1
1 1 1 1 1 1 1 1
1 2 1 1 1 1 2 1
2 1 1 1 1 1 1 2
5 7 6 4